11111111111
1P000000001
11111C11111
1000C000001
11111101011
1000000C0E1
11111111111